"filename", "language", "CSS", "JavaScript", "XML", "JavaScript JSX", "JSON", "comment", "blank", "total"
"c:\Users\Inframet\Desktop\infrabox\INFRABOX\src\App.css", "CSS", 11, 0, 0, 0, 0, 0, 2, 13
"c:\Users\Inframet\Desktop\infrabox\INFRABOX\src\App.js", "JavaScript", 0, 53, 0, 0, 0, 12, 4, 69
"c:\Users\Inframet\Desktop\infrabox\INFRABOX\src\App.test.js", "JavaScript", 0, 7, 0, 0, 0, 0, 2, 9
"c:\Users\Inframet\Desktop\infrabox\INFRABOX\src\assets\Lottie\add.json", "JSON", 0, 0, 0, 0, 475, 0, 1, 476
"c:\Users\Inframet\Desktop\infrabox\INFRABOX\src\assets\Lottie\box_v2.json", "JSON", 0, 0, 0, 0, 42523, 0, 1, 42524
"c:\Users\Inframet\Desktop\infrabox\INFRABOX\src\assets\Lottie\calculation.json", "JSON", 0, 0, 0, 0, 22049, 0, 1, 22050
"c:\Users\Inframet\Desktop\infrabox\INFRABOX\src\assets\Lottie\contact.json", "JSON", 0, 0, 0, 0, 3047, 0, 1, 3048
"c:\Users\Inframet\Desktop\infrabox\INFRABOX\src\assets\Lottie\delete.json", "JSON", 0, 0, 0, 0, 887, 0, 1, 888
"c:\Users\Inframet\Desktop\infrabox\INFRABOX\src\assets\Lottie\department_cost.json", "JSON", 0, 0, 0, 0, 15112, 0, 1, 15113
"c:\Users\Inframet\Desktop\infrabox\INFRABOX\src\assets\Lottie\department_cost2.json", "JSON", 0, 0, 0, 0, 12030, 0, 1, 12031
"c:\Users\Inframet\Desktop\infrabox\INFRABOX\src\assets\Lottie\department_cost3.json", "JSON", 0, 0, 0, 0, 16551, 0, 1, 16552
"c:\Users\Inframet\Desktop\infrabox\INFRABOX\src\assets\Lottie\eco_v4.json", "JSON", 0, 0, 0, 0, 26462, 0, 1, 26463
"c:\Users\Inframet\Desktop\infrabox\INFRABOX\src\assets\Lottie\edit.json", "JSON", 0, 0, 0, 0, 828, 0, 1, 829
"c:\Users\Inframet\Desktop\infrabox\INFRABOX\src\assets\Lottie\error.json", "JSON", 0, 0, 0, 0, 376, 0, 1, 377
"c:\Users\Inframet\Desktop\infrabox\INFRABOX\src\assets\Lottie\infinite.json", "JSON", 0, 0, 0, 0, 1299, 0, 1, 1300
"c:\Users\Inframet\Desktop\infrabox\INFRABOX\src\assets\Lottie\info.json", "JSON", 0, 0, 0, 0, 715, 0, 1, 716
"c:\Users\Inframet\Desktop\infrabox\INFRABOX\src\assets\Lottie\loading.json", "JSON", 0, 0, 0, 0, 8986, 0, 1, 8987
"c:\Users\Inframet\Desktop\infrabox\INFRABOX\src\assets\Lottie\logout.json", "JSON", 0, 0, 0, 0, 360, 0, 1, 361
"c:\Users\Inframet\Desktop\infrabox\INFRABOX\src\assets\Lottie\my_profile.json", "JSON", 0, 0, 0, 0, 10754, 0, 1, 10755
"c:\Users\Inframet\Desktop\infrabox\INFRABOX\src\assets\Lottie\network.json", "JSON", 0, 0, 0, 0, 45690, 0, 1, 45691
"c:\Users\Inframet\Desktop\infrabox\INFRABOX\src\assets\Lottie\no-data-animation.json", "JSON", 0, 0, 0, 0, 291, 0, 1, 292
"c:\Users\Inframet\Desktop\infrabox\INFRABOX\src\assets\Lottie\no-data.json", "JSON", 0, 0, 0, 0, 454, 0, 1, 455
"c:\Users\Inframet\Desktop\infrabox\INFRABOX\src\assets\Lottie\no_price_data.json", "JSON", 0, 0, 0, 0, 537, 0, 1, 538
"c:\Users\Inframet\Desktop\infrabox\INFRABOX\src\assets\Lottie\notification.json", "JSON", 0, 0, 0, 0, 3708, 0, 1, 3709
"c:\Users\Inframet\Desktop\infrabox\INFRABOX\src\assets\Lottie\order.json", "JSON", 0, 0, 0, 0, 2528, 0, 1, 2529
"c:\Users\Inframet\Desktop\infrabox\INFRABOX\src\assets\Lottie\profile.json", "JSON", 0, 0, 0, 0, 10772, 0, 1, 10773
"c:\Users\Inframet\Desktop\infrabox\INFRABOX\src\assets\system.svg", "XML", 0, 0, 2, 0, 0, 1, 0, 3
"c:\Users\Inframet\Desktop\infrabox\INFRABOX\src\components\Infrabox.jsx", "JavaScript JSX", 0, 0, 0, 28, 0, 0, 4, 32
"c:\Users\Inframet\Desktop\infrabox\INFRABOX\src\components\calculation\CalculationItem.jsx", "JavaScript JSX", 0, 0, 0, 939, 0, 0, 30, 969
"c:\Users\Inframet\Desktop\infrabox\INFRABOX\src\components\calculation\CalculationList.jsx", "JavaScript JSX", 0, 0, 0, 170, 0, 0, 17, 187
"c:\Users\Inframet\Desktop\infrabox\INFRABOX\src\components\calculation\Calculations.jsx", "JavaScript JSX", 0, 0, 0, 91, 0, 0, 6, 97
"c:\Users\Inframet\Desktop\infrabox\INFRABOX\src\components\calculation\css\CalculationItem.module.css", "CSS", 135, 0, 0, 0, 0, 4, 9, 148
"c:\Users\Inframet\Desktop\infrabox\INFRABOX\src\components\calculation\css\CalculationList.module.css", "CSS", 124, 0, 0, 0, 0, 4, 13, 141
"c:\Users\Inframet\Desktop\infrabox\INFRABOX\src\components\calculation\css\Calculations.module.css", "CSS", 7, 0, 0, 0, 0, 0, 1, 8
"c:\Users\Inframet\Desktop\infrabox\INFRABOX\src\components\calculation\service\calculationManager.js", "JavaScript", 0, 58, 0, 0, 0, 0, 4, 62
"c:\Users\Inframet\Desktop\infrabox\INFRABOX\src\components\calculation\validationSchema\calculationItemValidationSchema.js", "JavaScript", 0, 24, 0, 0, 0, 0, 2, 26
"c:\Users\Inframet\Desktop\infrabox\INFRABOX\src\components\cart\Cart.jsx", "JavaScript JSX", 0, 0, 0, 137, 0, 1, 15, 153
"c:\Users\Inframet\Desktop\infrabox\INFRABOX\src\components\cart\css\Cart.module.css", "CSS", 125, 0, 0, 0, 0, 4, 6, 135
"c:\Users\Inframet\Desktop\infrabox\INFRABOX\src\components\cart\service\cartManager.js", "JavaScript", 0, 92, 0, 0, 0, 0, 22, 114
"c:\Users\Inframet\Desktop\infrabox\INFRABOX\src\components\common\DeleteModal.jsx", "JavaScript JSX", 0, 0, 0, 30, 0, 0, 4, 34
"c:\Users\Inframet\Desktop\infrabox\INFRABOX\src\components\common\Error.jsx", "JavaScript JSX", 0, 0, 0, 25, 0, 0, 5, 30
"c:\Users\Inframet\Desktop\infrabox\INFRABOX\src\components\common\InfoModal.jsx", "JavaScript JSX", 0, 0, 0, 28, 0, 0, 3, 31
"c:\Users\Inframet\Desktop\infrabox\INFRABOX\src\components\common\Input.jsx", "JavaScript JSX", 0, 0, 0, 28, 0, 0, 2, 30
"c:\Users\Inframet\Desktop\infrabox\INFRABOX\src\components\common\Loader.jsx", "JavaScript JSX", 0, 0, 0, 25, 0, 0, 5, 30
"c:\Users\Inframet\Desktop\infrabox\INFRABOX\src\components\common\Notifications.jsx", "JavaScript JSX", 0, 0, 0, 17, 0, 0, 2, 19
"c:\Users\Inframet\Desktop\infrabox\INFRABOX\src\components\common\PriceChart.jsx", "JavaScript JSX", 0, 0, 0, 86, 0, 0, 7, 93
"c:\Users\Inframet\Desktop\infrabox\INFRABOX\src\components\common\css\DeleteModal.module.css", "CSS", 101, 0, 0, 0, 0, 4, 4, 109
"c:\Users\Inframet\Desktop\infrabox\INFRABOX\src\components\common\css\Error.module.css", "CSS", 41, 0, 0, 0, 0, 0, 1, 42
"c:\Users\Inframet\Desktop\infrabox\INFRABOX\src\components\common\css\InfoModal.module.css", "CSS", 103, 0, 0, 0, 0, 4, 6, 113
"c:\Users\Inframet\Desktop\infrabox\INFRABOX\src\components\common\css\Loader.module.css", "CSS", 42, 0, 0, 0, 0, 0, 1, 43
"c:\Users\Inframet\Desktop\infrabox\INFRABOX\src\components\common\css\PriceChart.module.css", "CSS", 104, 0, 0, 0, 0, 4, 5, 113
"c:\Users\Inframet\Desktop\infrabox\INFRABOX\src\components\common\service\showNotification.js", "JavaScript", 0, 6, 0, 0, 0, 0, 2, 8
"c:\Users\Inframet\Desktop\infrabox\INFRABOX\src\components\dashboard\Dashboard.jsx", "JavaScript JSX", 0, 0, 0, 116, 0, 0, 2, 118
"c:\Users\Inframet\Desktop\infrabox\INFRABOX\src\components\dashboard\css\Dashboard.module.css", "CSS", 47, 0, 0, 0, 0, 0, 8, 55
"c:\Users\Inframet\Desktop\infrabox\INFRABOX\src\components\header\Header.jsx", "JavaScript JSX", 0, 0, 0, 93, 0, 0, 11, 104
"c:\Users\Inframet\Desktop\infrabox\INFRABOX\src\components\header\Header.module.css", "CSS", 42, 0, 0, 0, 0, 4, 3, 49
"c:\Users\Inframet\Desktop\infrabox\INFRABOX\src\components\login\Login.jsx", "JavaScript JSX", 0, 0, 0, 84, 0, 0, 6, 90
"c:\Users\Inframet\Desktop\infrabox\INFRABOX\src\components\login\Login.module.css", "CSS", 119, 0, 0, 0, 0, 5, 4, 128
"c:\Users\Inframet\Desktop\infrabox\INFRABOX\src\components\login\validationSchema.js", "JavaScript", 0, 5, 0, 0, 0, 0, 2, 7
"c:\Users\Inframet\Desktop\infrabox\INFRABOX\src\components\logout\Logout.jsx", "JavaScript JSX", 0, 0, 0, 29, 0, 0, 3, 32
"c:\Users\Inframet\Desktop\infrabox\INFRABOX\src\components\logout\Logout.module.css", "CSS", 62, 0, 0, 0, 0, 4, 4, 70
"c:\Users\Inframet\Desktop\infrabox\INFRABOX\src\components\main\Main.jsx", "JavaScript JSX", 0, 0, 0, 62, 0, 0, 4, 66
"c:\Users\Inframet\Desktop\infrabox\INFRABOX\src\components\main\Main.module.css", "CSS", 45, 0, 0, 0, 0, 4, 3, 52
"c:\Users\Inframet\Desktop\infrabox\INFRABOX\src\components\material\Dimensions.jsx", "JavaScript JSX", 0, 0, 0, 158, 0, 0, 3, 161
"c:\Users\Inframet\Desktop\infrabox\INFRABOX\src\components\material\GlobalFilter.jsx", "JavaScript JSX", 0, 0, 0, 21, 0, 0, 2, 23
"c:\Users\Inframet\Desktop\infrabox\INFRABOX\src\components\material\MaterialGroupItem.jsx", "JavaScript JSX", 0, 0, 0, 101, 0, 0, 7, 108
"c:\Users\Inframet\Desktop\infrabox\INFRABOX\src\components\material\MaterialGroupItemDetails.jsx", "JavaScript JSX", 0, 0, 0, 75, 0, 0, 8, 83
"c:\Users\Inframet\Desktop\infrabox\INFRABOX\src\components\material\MaterialGroupList.jsx", "JavaScript JSX", 0, 0, 0, 73, 0, 0, 5, 78
"c:\Users\Inframet\Desktop\infrabox\INFRABOX\src\components\material\MaterialGroupModal_ADD.jsx", "JavaScript JSX", 0, 0, 0, 150, 0, 1, 7, 158
"c:\Users\Inframet\Desktop\infrabox\INFRABOX\src\components\material\MaterialGroupModal_EDIT.jsx", "JavaScript JSX", 0, 0, 0, 148, 0, 1, 8, 157
"c:\Users\Inframet\Desktop\infrabox\INFRABOX\src\components\material\MaterialList.jsx", "JavaScript JSX", 0, 0, 0, 215, 0, 3, 41, 259
"c:\Users\Inframet\Desktop\infrabox\INFRABOX\src\components\material\MaterialModal_ADD.jsx", "JavaScript JSX", 0, 0, 0, 209, 0, 0, 15, 224
"c:\Users\Inframet\Desktop\infrabox\INFRABOX\src\components\material\MaterialModal_EDIT.jsx", "JavaScript JSX", 0, 0, 0, 216, 0, 0, 13, 229
"c:\Users\Inframet\Desktop\infrabox\INFRABOX\src\components\material\Result.jsx", "JavaScript JSX", 0, 0, 0, 26, 0, 0, 2, 28
"c:\Users\Inframet\Desktop\infrabox\INFRABOX\src\components\material\TableColumn.jsx", "JavaScript JSX", 0, 0, 0, 265, 0, 0, 38, 303
"c:\Users\Inframet\Desktop\infrabox\INFRABOX\src\components\material\css\Material.module.css", "CSS", 76, 0, 0, 0, 0, 4, 6, 86
"c:\Users\Inframet\Desktop\infrabox\INFRABOX\src\components\material\css\MaterialGroupList.module.css", "CSS", 39, 0, 0, 0, 0, 0, 3, 42
"c:\Users\Inframet\Desktop\infrabox\INFRABOX\src\components\material\css\MaterialItem.module.css", "CSS", 19, 0, 0, 0, 0, 0, 2, 21
"c:\Users\Inframet\Desktop\infrabox\INFRABOX\src\components\material\css\MaterialItemDetails.module.css", "CSS", 23, 0, 0, 0, 0, 0, 2, 25
"c:\Users\Inframet\Desktop\infrabox\INFRABOX\src\components\material\css\MaterialList.module.css", "CSS", 121, 0, 0, 0, 0, 0, 23, 144
"c:\Users\Inframet\Desktop\infrabox\INFRABOX\src\components\material\css\MaterialModal.module.css", "CSS", 113, 0, 0, 0, 0, 4, 8, 125
"c:\Users\Inframet\Desktop\infrabox\INFRABOX\src\components\material\css\Result.module.css", "CSS", 3, 0, 0, 0, 0, 0, 1, 4
"c:\Users\Inframet\Desktop\infrabox\INFRABOX\src\components\material\css\TableColumn.module.css", "CSS", 27, 0, 0, 0, 0, 0, 4, 31
"c:\Users\Inframet\Desktop\infrabox\INFRABOX\src\components\material\service\calcualteTotalPrice.js", "JavaScript", 0, 4, 0, 0, 0, 0, 1, 5
"c:\Users\Inframet\Desktop\infrabox\INFRABOX\src\components\material\service\calcualteVolume.js", "JavaScript", 0, 13, 0, 0, 0, 0, 1, 14
"c:\Users\Inframet\Desktop\infrabox\INFRABOX\src\components\material\service\calculatePrice.js", "JavaScript", 0, 4, 0, 0, 0, 0, 1, 5
"c:\Users\Inframet\Desktop\infrabox\INFRABOX\src\components\material\service\calculateWeight.js", "JavaScript", 0, 4, 0, 0, 0, 0, 1, 5
"c:\Users\Inframet\Desktop\infrabox\INFRABOX\src\components\material\service\materialList.js", "JavaScript", 0, 110, 0, 0, 0, 0, 1, 111
"c:\Users\Inframet\Desktop\infrabox\INFRABOX\src\components\material\service\materialManager.js", "JavaScript", 0, 161, 0, 0, 0, 0, 9, 170
"c:\Users\Inframet\Desktop\infrabox\INFRABOX\src\components\material\validationSchema\materialGroupValidationSchema.js", "JavaScript", 0, 27, 0, 0, 0, 1, 5, 33
"c:\Users\Inframet\Desktop\infrabox\INFRABOX\src\components\material\validationSchema\plateValidationSchema.js", "JavaScript", 0, 18, 0, 0, 0, 0, 2, 20
"c:\Users\Inframet\Desktop\infrabox\INFRABOX\src\components\material\validationSchema\rodValidationSchema.js", "JavaScript", 0, 23, 0, 0, 0, 0, 2, 25
"c:\Users\Inframet\Desktop\infrabox\INFRABOX\src\components\material\validationSchema\tubeValidationSchema.js", "JavaScript", 0, 27, 0, 0, 0, 0, 2, 29
"c:\Users\Inframet\Desktop\infrabox\INFRABOX\src\components\navSidebar\NavSidebar.jsx", "JavaScript JSX", 0, 0, 0, 110, 0, 2, 4, 116
"c:\Users\Inframet\Desktop\infrabox\INFRABOX\src\components\navSidebar\NavSidebar.module.css", "CSS", 96, 0, 0, 0, 0, 5, 13, 114
"c:\Users\Inframet\Desktop\infrabox\INFRABOX\src\components\notification\Notification.jsx", "JavaScript JSX", 0, 0, 0, 254, 0, 0, 15, 269
"c:\Users\Inframet\Desktop\infrabox\INFRABOX\src\components\notification\css\Notification.module.css", "CSS", 162, 0, 0, 0, 0, 4, 7, 173
"c:\Users\Inframet\Desktop\infrabox\INFRABOX\src\components\notification\service\notificationManager.js", "JavaScript", 0, 0, 0, 0, 0, 0, 1, 1
"c:\Users\Inframet\Desktop\infrabox\INFRABOX\src\components\order\OrderItem.jsx", "JavaScript JSX", 0, 0, 0, 550, 0, 4, 28, 582
"c:\Users\Inframet\Desktop\infrabox\INFRABOX\src\components\order\OrderList.jsx", "JavaScript JSX", 0, 0, 0, 85, 0, 0, 6, 91
"c:\Users\Inframet\Desktop\infrabox\INFRABOX\src\components\order\OrderTable.jsx", "JavaScript JSX", 0, 0, 0, 185, 0, 0, 22, 207
"c:\Users\Inframet\Desktop\infrabox\INFRABOX\src\components\order\css\OrderItem.module.css", "CSS", 177, 0, 0, 0, 0, 4, 10, 191
"c:\Users\Inframet\Desktop\infrabox\INFRABOX\src\components\order\css\OrderList.module.css", "CSS", 7, 0, 0, 0, 0, 0, 1, 8
"c:\Users\Inframet\Desktop\infrabox\INFRABOX\src\components\order\css\OrderTable.module.css", "CSS", 154, 0, 0, 0, 0, 4, 15, 173
"c:\Users\Inframet\Desktop\infrabox\INFRABOX\src\components\order\service\orderManager.js", "JavaScript", 0, 108, 0, 0, 0, 2, 4, 114
"c:\Users\Inframet\Desktop\infrabox\INFRABOX\src\components\order\service\validationSchema\orderItemValidationSchema.js", "JavaScript", 0, 4, 0, 0, 0, 0, 2, 6
"c:\Users\Inframet\Desktop\infrabox\INFRABOX\src\components\recycling\RecycleItem.jsx", "JavaScript JSX", 0, 0, 0, 364, 0, 0, 26, 390
"c:\Users\Inframet\Desktop\infrabox\INFRABOX\src\components\recycling\RecycleList.jsx", "JavaScript JSX", 0, 0, 0, 94, 0, 0, 5, 99
"c:\Users\Inframet\Desktop\infrabox\INFRABOX\src\components\recycling\WTCList.jsx", "JavaScript JSX", 0, 0, 0, 159, 0, 0, 20, 179
"c:\Users\Inframet\Desktop\infrabox\INFRABOX\src\components\recycling\css\RecycleItem.module.css", "CSS", 158, 0, 0, 0, 0, 4, 7, 169
"c:\Users\Inframet\Desktop\infrabox\INFRABOX\src\components\recycling\css\RecycleList.module.css", "CSS", 6, 0, 0, 0, 0, 0, 1, 7
"c:\Users\Inframet\Desktop\infrabox\INFRABOX\src\components\recycling\css\WTCList.module.css", "CSS", 97, 0, 0, 0, 0, 4, 12, 113
"c:\Users\Inframet\Desktop\infrabox\INFRABOX\src\components\recycling\service\recycleManager.js", "JavaScript", 0, 58, 0, 0, 0, 0, 4, 62
"c:\Users\Inframet\Desktop\infrabox\INFRABOX\src\components\recycling\service\validationSchema\recycleValidationSchema.js", "JavaScript", 0, 7, 0, 0, 0, 0, 2, 9
"c:\Users\Inframet\Desktop\infrabox\INFRABOX\src\components\recycling\service\validationSchema\wasteValidationSchema.js", "JavaScript", 0, 9, 0, 0, 0, 0, 2, 11
"c:\Users\Inframet\Desktop\infrabox\INFRABOX\src\components\settings\Contact.jsx", "JavaScript JSX", 0, 0, 0, 38, 0, 0, 3, 41
"c:\Users\Inframet\Desktop\infrabox\INFRABOX\src\components\settings\DepartmentCost.jsx", "JavaScript JSX", 0, 0, 0, 288, 0, 0, 6, 294
"c:\Users\Inframet\Desktop\infrabox\INFRABOX\src\components\settings\Settings.jsx", "JavaScript JSX", 0, 0, 0, 85, 0, 0, 10, 95
"c:\Users\Inframet\Desktop\infrabox\INFRABOX\src\components\settings\User.jsx", "JavaScript JSX", 0, 0, 0, 145, 0, 0, 14, 159
"c:\Users\Inframet\Desktop\infrabox\INFRABOX\src\components\settings\UserDetails.jsx", "JavaScript JSX", 0, 0, 0, 204, 0, 0, 9, 213
"c:\Users\Inframet\Desktop\infrabox\INFRABOX\src\components\settings\UserList.jsx", "JavaScript JSX", 0, 0, 0, 85, 0, 0, 5, 90
"c:\Users\Inframet\Desktop\infrabox\INFRABOX\src\components\settings\UserModal.jsx", "JavaScript JSX", 0, 0, 0, 178, 0, 0, 7, 185
"c:\Users\Inframet\Desktop\infrabox\INFRABOX\src\components\settings\css\Contact.module.css", "CSS", 65, 0, 0, 0, 0, 0, 4, 69
"c:\Users\Inframet\Desktop\infrabox\INFRABOX\src\components\settings\css\DepartmentCost.module.css", "CSS", 63, 0, 0, 0, 0, 0, 2, 65
"c:\Users\Inframet\Desktop\infrabox\INFRABOX\src\components\settings\css\Settings.module.css", "CSS", 10, 0, 0, 0, 0, 0, 2, 12
"c:\Users\Inframet\Desktop\infrabox\INFRABOX\src\components\settings\css\User.module.css", "CSS", 61, 0, 0, 0, 0, 0, 5, 66
"c:\Users\Inframet\Desktop\infrabox\INFRABOX\src\components\settings\css\UserDetails.module.css", "CSS", 89, 0, 0, 0, 0, 0, 6, 95
"c:\Users\Inframet\Desktop\infrabox\INFRABOX\src\components\settings\css\UserList.module.css", "CSS", 11, 0, 0, 0, 0, 0, 2, 13
"c:\Users\Inframet\Desktop\infrabox\INFRABOX\src\components\settings\css\UserModal.module.css", "CSS", 70, 0, 0, 0, 0, 4, 7, 81
"c:\Users\Inframet\Desktop\infrabox\INFRABOX\src\components\settings\service\departmentCostManager.js", "JavaScript", 0, 31, 0, 0, 0, 0, 4, 35
"c:\Users\Inframet\Desktop\infrabox\INFRABOX\src\components\settings\service\userManager.js", "JavaScript", 0, 73, 0, 0, 0, 1, 7, 81
"c:\Users\Inframet\Desktop\infrabox\INFRABOX\src\components\settings\service\validationSchema\departmentCostValidationSchema.js", "JavaScript", 0, 14, 0, 0, 0, 0, 2, 16
"c:\Users\Inframet\Desktop\infrabox\INFRABOX\src\components\settings\service\validationSchema\userModalValidationSchema.js", "JavaScript", 0, 18, 0, 0, 0, 0, 2, 20
"c:\Users\Inframet\Desktop\infrabox\INFRABOX\src\components\settings\service\validationSchema\userUpdateModalValidationSchema.js", "JavaScript", 0, 11, 0, 0, 0, 0, 2, 13
"c:\Users\Inframet\Desktop\infrabox\INFRABOX\src\components\settings\service\validationSchema\userValidationSchema.js", "JavaScript", 0, 11, 0, 0, 0, 0, 2, 13
"c:\Users\Inframet\Desktop\infrabox\INFRABOX\src\components\supplier\SupplierForm.jsx", "JavaScript JSX", 0, 0, 0, 305, 0, 0, 13, 318
"c:\Users\Inframet\Desktop\infrabox\INFRABOX\src\components\supplier\SupplierItem.jsx", "JavaScript JSX", 0, 0, 0, 94, 0, 0, 10, 104
"c:\Users\Inframet\Desktop\infrabox\INFRABOX\src\components\supplier\SupplierList.jsx", "JavaScript JSX", 0, 0, 0, 98, 0, 0, 6, 104
"c:\Users\Inframet\Desktop\infrabox\INFRABOX\src\components\supplier\css\SupplierForm.module.css", "CSS", 75, 0, 0, 0, 0, 0, 7, 82
"c:\Users\Inframet\Desktop\infrabox\INFRABOX\src\components\supplier\css\SupplierItem.module.css", "CSS", 116, 0, 0, 0, 0, 0, 10, 126
"c:\Users\Inframet\Desktop\infrabox\INFRABOX\src\components\supplier\css\SupplierList.module.css", "CSS", 35, 0, 0, 0, 0, 4, 3, 42
"c:\Users\Inframet\Desktop\infrabox\INFRABOX\src\components\supplier\service\supplierManager.js", "JavaScript", 0, 60, 0, 0, 0, 0, 4, 64
"c:\Users\Inframet\Desktop\infrabox\INFRABOX\src\components\supplier\service\validationSchema\supplierValidationSchema.js", "JavaScript", 0, 34, 0, 0, 0, 1, 5, 40
"c:\Users\Inframet\Desktop\infrabox\INFRABOX\src\components\tool\Dimensions.jsx", "JavaScript JSX", 0, 0, 0, 61, 0, 0, 3, 64
"c:\Users\Inframet\Desktop\infrabox\INFRABOX\src\components\tool\GlobalFilter.jsx", "JavaScript JSX", 0, 0, 0, 21, 0, 0, 2, 23
"c:\Users\Inframet\Desktop\infrabox\INFRABOX\src\components\tool\Result.jsx", "JavaScript JSX", 0, 0, 0, 23, 0, 0, 2, 25
"c:\Users\Inframet\Desktop\infrabox\INFRABOX\src\components\tool\TableColumn.jsx", "JavaScript JSX", 0, 0, 0, 93, 0, 0, 14, 107
"c:\Users\Inframet\Desktop\infrabox\INFRABOX\src\components\tool\ToolGroupItem.jsx", "JavaScript JSX", 0, 0, 0, 101, 0, 0, 6, 107
"c:\Users\Inframet\Desktop\infrabox\INFRABOX\src\components\tool\ToolGroupItemDetails.jsx", "JavaScript JSX", 0, 0, 0, 81, 0, 0, 7, 88
"c:\Users\Inframet\Desktop\infrabox\INFRABOX\src\components\tool\ToolGroupList.jsx", "JavaScript JSX", 0, 0, 0, 73, 0, 0, 3, 76
"c:\Users\Inframet\Desktop\infrabox\INFRABOX\src\components\tool\ToolGroupModal_ADD.jsx", "JavaScript JSX", 0, 0, 0, 137, 0, 1, 8, 146
"c:\Users\Inframet\Desktop\infrabox\INFRABOX\src\components\tool\ToolGroupModal_EDIT.jsx", "JavaScript JSX", 0, 0, 0, 92, 0, 0, 7, 99
"c:\Users\Inframet\Desktop\infrabox\INFRABOX\src\components\tool\ToolList.jsx", "JavaScript JSX", 0, 0, 0, 209, 0, 3, 42, 254
"c:\Users\Inframet\Desktop\infrabox\INFRABOX\src\components\tool\ToolModal_ADD.jsx", "JavaScript JSX", 0, 0, 0, 198, 0, 0, 8, 206
"c:\Users\Inframet\Desktop\infrabox\INFRABOX\src\components\tool\ToolModal_EDIT.jsx", "JavaScript JSX", 0, 0, 0, 196, 0, 0, 6, 202
"c:\Users\Inframet\Desktop\infrabox\INFRABOX\src\components\tool\css\Result.module.css", "CSS", 3, 0, 0, 0, 0, 0, 1, 4
"c:\Users\Inframet\Desktop\infrabox\INFRABOX\src\components\tool\css\TableColumn.module.css", "CSS", 27, 0, 0, 0, 0, 0, 4, 31
"c:\Users\Inframet\Desktop\infrabox\INFRABOX\src\components\tool\css\Tool.module.css", "CSS", 66, 0, 0, 0, 0, 4, 6, 76
"c:\Users\Inframet\Desktop\infrabox\INFRABOX\src\components\tool\css\ToolGroupItem.module.css", "CSS", 18, 0, 0, 0, 0, 0, 2, 20
"c:\Users\Inframet\Desktop\infrabox\INFRABOX\src\components\tool\css\ToolGroupItemDetails.module.css", "CSS", 23, 0, 0, 0, 0, 0, 2, 25
"c:\Users\Inframet\Desktop\infrabox\INFRABOX\src\components\tool\css\ToolGroupList.module.css", "CSS", 36, 0, 0, 0, 0, 0, 1, 37
"c:\Users\Inframet\Desktop\infrabox\INFRABOX\src\components\tool\css\ToolList.module.css", "CSS", 119, 0, 0, 0, 0, 4, 19, 142
"c:\Users\Inframet\Desktop\infrabox\INFRABOX\src\components\tool\css\ToolModal.module.css", "CSS", 88, 0, 0, 0, 0, 4, 5, 97
"c:\Users\Inframet\Desktop\infrabox\INFRABOX\src\components\tool\service\toolManager.js", "JavaScript", 0, 161, 0, 0, 0, 0, 8, 169
"c:\Users\Inframet\Desktop\infrabox\INFRABOX\src\components\tool\validationSchema\toolGroupValidationSchema.js", "JavaScript", 0, 26, 0, 0, 0, 1, 5, 32
"c:\Users\Inframet\Desktop\infrabox\INFRABOX\src\components\tool\validationSchema\toolValidationSchema.js", "JavaScript", 0, 22, 0, 0, 0, 0, 2, 24
"c:\Users\Inframet\Desktop\infrabox\INFRABOX\src\index.css", "CSS", 10, 0, 0, 0, 0, 0, 2, 12
"c:\Users\Inframet\Desktop\infrabox\INFRABOX\src\index.js", "JavaScript", 0, 12, 0, 0, 0, 3, 3, 18
"c:\Users\Inframet\Desktop\infrabox\INFRABOX\src\logo.svg", "XML", 0, 0, 1, 0, 0, 0, 0, 1
"c:\Users\Inframet\Desktop\infrabox\INFRABOX\src\redux\actionTypes\actionTypes.js", "JavaScript", 0, 6, 0, 0, 0, 0, 1, 7
"c:\Users\Inframet\Desktop\infrabox\INFRABOX\src\redux\actions\Action.js", "JavaScript", 0, 51, 0, 0, 0, 0, 8, 59
"c:\Users\Inframet\Desktop\infrabox\INFRABOX\src\redux\reducers\reducer.js", "JavaScript", 0, 53, 0, 0, 0, 0, 10, 63
"c:\Users\Inframet\Desktop\infrabox\INFRABOX\src\redux\store.js", "JavaScript", 0, 4, 0, 0, 0, 0, 3, 7
"c:\Users\Inframet\Desktop\infrabox\INFRABOX\src\reportWebVitals.js", "JavaScript", 0, 12, 0, 0, 0, 0, 2, 14
"c:\Users\Inframet\Desktop\infrabox\INFRABOX\src\setupTests.js", "JavaScript", 0, 1, 0, 0, 0, 4, 1, 6
"Total", "-", 3371, 1422, 3, 8251, 226434, 136, 1039, 240656